XXXXXXXXXXXXXXXXXXXXXXXXXXXXXXXXXXXXXXXXX
Xe22222222222333333X3333333331111111111dX
X333333333333333322X22222222221111111111X
X111111111111111222222222222222333333333X
X222222222222222222X22333333333333333333X
X333333333333333333X33222222222222222222X
XXXXXXXXX22XXXXXXXXXXXXXXXXXXXX11XXXXXXXX
X11111111111111111aX11222222222222222222X
X111111111111111111X11111111111111111111X
X222222222222222222222222222222222222222X
X333333333333333333X33333333333333333333X
X222222222222222222X22222222222222222222X
Xb11111111111111111X1111111111111111111cX
XXXXXXXXXXXXXXXXXXXXXXXXXXXXXXXXXXXXXXXXX

Total cost =  24.65685424949238 

XXXXXXXXXXXXXXXXXXXXXXXXXXXXXXXXXXXXXXXXX
Xe22222222222333333X3333333331111111111dX
X333333333333333322X22222222221111111111X
X111111111111111222222222222222333333333X
X222222222222222222X22333333333333333333X
X333333333333333333X33222222222222222222X
XXXXXXXXX22XXXXXXXXXXXXXXXXXXXX11XXXXXXXX
X111***************X11222222222222222222X
X11*111111111111111X11111111111111111111X
X2*2222222222222222222222222222222222222X
X3*3333333333333333X33333333333333333333X
X2*2222222222222222X22222222222222222222X
X*11111111111111111X1111111111111111111cX
XXXXXXXXXXXXXXXXXXXXXXXXXXXXXXXXXXXXXXXXX

XXXXXXXXXXXXXXXXXXXXXXXXXXXXXXXXXXXXXXXXX
Xe22222222222333333X3333333331111111111dX
X333333333333333322X22222222221111111111X
X111111111111111222222222222222333333333X
X222222222222222222X22333333333333333333X
X333333333333333333X33222222222222222222X
XXXXXXXXX22XXXXXXXXXXXXXXXXXXXX11XXXXXXXX
X11111111111111111aX11222222222222222222X
X111111111111111111X11111111111111111111X
X222222222222222222222222222222222222222X
X333333333333333333X33333333333333333333X
X222222222222222222X22222222222222222222X
Xb11111111111111111X1111111111111111111cX
XXXXXXXXXXXXXXXXXXXXXXXXXXXXXXXXXXXXXXXXX

Total cost =  29.27817459305202 

XXXXXXXXXXXXXXXXXXXXXXXXXXXXXXXXXXXXXXXXX
Xe22222222222333333X3333333331111111111dX
X333333333333333322X22222222221111111111X
X111111111111111222222222222222333333333X
X222222222222222222X22333333333333333333X
X333333333333333333X33222222222222222222X
XXXXXXXXX22XXXXXXXXXXXXXXXXXXXX11XXXXXXXX
X11111111111111111*X11222222222222222222X
X11111111111111111*X11111111111111111111X
X222222222222222222*22222222222222222222X
X333333333333333333X*3333333333333333333X
X222222222222222222X*2222222222222222222X
Xb11111111111111111X1*******************X
XXXXXXXXXXXXXXXXXXXXXXXXXXXXXXXXXXXXXXXXX

XXXXXXXXXXXXXXXXXXXXXXXXXXXXXXXXXXXXXXXXX
Xe22222222222333333X3333333331111111111dX
X333333333333333322X22222222221111111111X
X111111111111111222222222222222333333333X
X222222222222222222X22333333333333333333X
X333333333333333333X33222222222222222222X
XXXXXXXXX22XXXXXXXXXXXXXXXXXXXX11XXXXXXXX
X11111111111111111aX11222222222222222222X
X111111111111111111X11111111111111111111X
X222222222222222222222222222222222222222X
X333333333333333333X33333333333333333333X
X222222222222222222X22222222222222222222X
Xb11111111111111111X1111111111111111111cX
XXXXXXXXXXXXXXXXXXXXXXXXXXXXXXXXXXXXXXXXX

Total cost =  35.3492424049175 

XXXXXXXXXXXXXXXXXXXXXXXXXXXXXXXXXXXXXXXXX
Xe22222222222333333X3333333331111111111*X
X333333333333333322X22222222221111*****1X
X11111111111111122222222222222233*333333X
X222222222222222222X2233333333333*333333X
X333333333333333333X3322222222222*222222X
XXXXXXXXX22XXXXXXXXXXXXXXXXXXXX1*XXXXXXXX
X11111111111111111*X11222222222*22222222X
X11111111111111111*X***********111111111X
X222222222222222222*22222222222222222222X
X333333333333333333X33333333333333333333X
X222222222222222222X22222222222222222222X
Xb11111111111111111X1111111111111111111cX
XXXXXXXXXXXXXXXXXXXXXXXXXXXXXXXXXXXXXXXXX

XXXXXXXXXXXXXXXXXXXXXXXXXXXXXXXXXXXXXXXXX
Xe22222222222333333X3333333331111111111dX
X333333333333333322X22222222221111111111X
X111111111111111222222222222222333333333X
X222222222222222222X22333333333333333333X
X333333333333333333X33222222222222222222X
XXXXXXXXX22XXXXXXXXXXXXXXXXXXXX11XXXXXXXX
X11111111111111111aX11222222222222222222X
X111111111111111111X11111111111111111111X
X222222222222222222222222222222222222222X
X333333333333333333X33333333333333333333X
X222222222222222222X22222222222222222222X
Xb11111111111111111X1111111111111111111cX
XXXXXXXXXXXXXXXXXXXXXXXXXXXXXXXXXXXXXXXXX

Total cost =  27.899494936611667 

XXXXXXXXXXXXXXXXXXXXXXXXXXXXXXXXXXXXXXXXX
X*22222222222333333X3333333331111111111dX
X3*3333333333333322X22222222221111111111X
X11******1111111222222222222222333333333X
X22222222*222222222X22333333333333333333X
X33333333*333333333X33222222222222222222X
XXXXXXXXX*2XXXXXXXXXXXXXXXXXXXX11XXXXXXXX
X111111111*********X11222222222222222222X
X111111111111111111X11111111111111111111X
X222222222222222222222222222222222222222X
X333333333333333333X33333333333333333333X
X222222222222222222X22222222222222222222X
Xb11111111111111111X1111111111111111111cX
XXXXXXXXXXXXXXXXXXXXXXXXXXXXXXXXXXXXXXXXX

XXXXXXXXXXXXXXXXXXXXXXXXXXXXXXXXXXXXXXXXX
Xe22222222222333333X3333333331111111111dX
X333333333333333322X22222222221111111111X
X111111111111111222222222222222333333333X
X222222222222222222X22333333333333333333X
X333333333333333333X33222222222222222222X
XXXXXXXXX22XXXXXXXXXXXXXXXXXXXX11XXXXXXXX
X11111111111111111aX11222222222222222222X
X111111111111111111X11111111111111111111X
X222222222222222222222222222222222222222X
X333333333333333333X33333333333333333333X
X222222222222222222X22222222222222222222X
Xb11111111111111111X1111111111111111111cX
XXXXXXXXXXXXXXXXXXXXXXXXXXXXXXXXXXXXXXXXX

Saved file: my_maze_costs.csv
