XXXXXXXXXXXXXXXXXXXXXXXXXXXXXXXXXXXXXXXXX
Xe22222222222333333X3333333331111111111dX
X333333333333333322X22222222221111111111X
X111111111111111222222222222222333333333X
X222222222222222222X22333333333333333333X
X333333333333333333X33222222222222222222X
XXXXXXXXX22XXXXXXXXXXXXXXXXXXXX11XXXXXXXX
X11111111111111111aX11222222222222222222X
X111111111111111111X11111111111111111111X
X222222222222222222222222222222222222222X
X333333333333333333X33333333333333333333X
X222222222222222222X22222222222222222222X
Xb11111111111111111X1111111111111111111cX
XXXXXXXXXXXXXXXXXXXXXXXXXXXXXXXXXXXXXXXXX
